0000000000000000000000000000
0111111111111001111111111110
0100001000001001000001000010
0200001000001001000001000020
0100001000001001000001000010
0111111111111111111111111110
0100001001000000001001000010
0100001001000000001001000010
0111111001111001111001111110
0000001000003003000001000000
0000001000003003000001000000
0000001003333333333001000000
3033301003000330003001000000
3030001003044444403001000000
3333301333044444403331333330
0030301003044444403001000000
3330301003000000003001000000
0000001003333333333001000000
0000001003000000003001000000
0000001003000000003001000000
0111111111111001111111111110
0100001000001001000001000010
0100001000001001000001000010
0211001111111331111111001120
0001001001000000001001001000
0001001001000000001001001000
0111111001111001111001111110
0100000000001001000000000010
0100000000001001000000000010
0111111111111111111111111110
0000000000000000000000000000