0000000000000000000000000000
0111111111111001111111111110
0100001000001001000001000010
0200001000001001000001000020
0100001000001001000001000010
0111111111111111111111111110
0100001001000000001001000010
0100001001000000001001000010
0111111001111001111001111110
0000001000003003000000100000
0000001000003003000000100000
0000001003333333333300100000
0000001003000330003001000000
0000001003044444403001000000
0000000000000000000000000000
0000000000000000000000000000
0000000000000000000000000000
0000000000000000000000000000
0000000000000000000000000000
0000000000000000000000000000